# My first level. There 2 two spare boulders. Only one of the non-end holes needs to be filled.
-------   ----
|.....|---|..|--------
|..>..|...|.o.....|..|
|.....|...|.-.-|..o..|
|.....|-^o|..o.|o.o..|
|.....|^.o..o<o|..o..|
|.....|...|..o...||..|
|+----------..-----.-|
|.^^^^^^^^^^o.o......|
----------------------
