# my second level...
                -------
----------------|.....|
|...........|..o.o.o..|
|.......<...|..o.o.o..|
|...........|..o.o.o..|
|+-----------.>o.o.o..|
|^^^^^^^^^^^^^.o.o.o..|
----------------|.....|
                -------
