# There should be 12 boulders on the 'o' square. Set it manually.
# There is one spare boulder.
                  ------      
------------  -----....--
|..........| -|..||.....|
|....<.....--|......-.-.|
|..........|..........|.|
|..........|..o..-......|
|+-----------|.....--...|
|.^^^^^^^^^^^...|>......|
-------------------------